.,.,.,.,.,.,.,.,.,.,.,.,.,.,.,.,.,.,.,.,.,.,.,.,.,.,.,.,.,.,.,.,.,.,.,.,.,.,.,.,.,.,.,.,.,.,.,.,.,.,.,.,.,.
.,.,.,P,.,.,.,.,.,P,.,.,.,.,.,.,.,.,.,.,.,.,.,.,.,.,.,.,.,.,.,.,.,.,.,.,.,.,.,.,.,.,.,.,.,.,.,.,.,.,.,.,.,.
.,.,.,A,.,.,.,.,.,A,.,.,.,.,.,.,.,.,.,.,.,.,.,.,.,.,.,.,.,.,.,.,.,.,.,.,.,.,.,.,.,.,.,.,.,.,.,.,.,.,.,.,.,.
.,.,.,P,.,.,.,.,.,P,.,.,.,.,.,P,P,P,.,.,.,.,.,.,C,.,.,.,.,.,.,.,.,.,.,.,.,.,.,P,.,P,.,.,.,.,.,P,.,.,.,.,.,.
.,.,.,.,.,.,.,.,.,.,.,.,.,.,.,.,B,.,.,.,.,.,.,P,P,P,.,.,.,.,.,.,.,.,.,.,.,.,.,A,.,J,.,.,.,.,.,A,.,.,.,.,.,.
.,.,.,.,.,P,.,.,.,.,.,.,.,.,.,P,P,P,.,.,.,.,.,.,.,.,.,.,.,.,.,P,.,.,.,.,.,.,.,P,.,P,.,.,C,.,.,P,.,.,.,.,.,.
.,.,.,.,.,J,.,.,.,.,.,.,.,.,.,.,.,.,.,.,P,.,.,.,.,.,.,P,.,.,.,.,.,.,.,.,.,.,.,.,.,.,.,.,P,.,.,.
.,.,.,.,P,P,P,.,.,.,.,C,.,.,.,.,.,.,.,.,.,.,.,.,.,.,.,.,.,.,.,.,.,.,.,P,.,.,.,.,.,.,.,B,.,.,.,.,.,B,.,.,.
.,.,.,.,.,.,.,.,.,.,P,P,P,.,.,.,.,.,.,.,.,.,.,.,.,.,P,.,.,.,P,.,.,.,.,.,.,.,.,.,.,.,.,P,P,P,.,.,P,P,P,.,.,.
G,G,G,G,G,G,G,G,G,G,G,G,G,G,G,G,G,G,G,G,G,G,G,G,G,G,G,G,G,G,G,G,G,G,G,G,G,G,G,G,G,G,G,G,G,G,G,G,G,G,G,E,G,G
D,D,D,D,D,D,D,D,D,D,D,D,D,D,D,D,D,D,D,D,D,D,D,D,D,D,D,D,D,D,D,D,D,D,D,D,D,D,D,D,D,D,D,D,D,D,D,D,D,D,D,D,D,D
D,D,D,D,D,D,D,D,D,D,D,D,D,D,D,D,D,D,D,D,D,D,D,D,D,D,D,D,D,D,D,D,D,D,D,D,D,D,D,D,D,D,D,D,D,D,D,D,D,D,D,D,D,D
D,D,D,D,D,D,D,D,D,D,D,D,D,D,D,D,D,D,D,D,D,D,D,D,D,D,D,D,D,D,D,D,D,D,D,D,D,D,D,D,D,D,D,D,D,D,D,D,D,D,D,D,D,D
D,D,D,D,D,D,D,D,D,D,D,D,D,D,D,D,D,D,D,D,D,D,D,D,D,D,D,D,D,D,D,D,D,D,D,D,D,D,D,D,D,D,D,D,D,D,D,D,D,D,D,D,D,D
D,D,D,D,D,D,D,D,D,D,D,D,D,D,D,D,D,D,D,D,D,D,D,D,D,D,D,D,D,D,D,D,D,D,D,D,D,D,D,D,D,D,D,D,D,D,D,D,D,D,D,D,D,D
D,D,D,D,D,D,D,D,D,D,D,D,D,D,D,D,D,D,D,D,D,D,D,D,D,D,D,D,D,D,D,D,D,D,D,D,D,D,D,D,D,D,D,D,D,D,D,D,D,D,D,D,D,D
D,D,D,D,D,D,D,D,D,D,D,D,D,D,D,D,D,D,D,D,D,D,D,D,D,D,D,D,D,D,D,D,D,D,D,D,D,D,D,D,D,D,D,D,D,D,D,D,D,D,D,D,D,D
